date,douban,douban_celebrity,imdb,bangumi,steam,indienova,epic,total_count
2025-10-01,973,1229,1300,5,3,0,0,3510
2025-09-30,1094,1323,1478,8,1,1,0,3905
2025-09-29,1023,1253,1462,9,1,0,0,3748
2025-09-28,1034,1320,1434,8,1,0,0,3797
2025-09-27,1166,1279,1486,6,3,0,0,3940
2025-09-26,1170,1242,1512,5,3,0,0,3932
2025-09-25,1046,1324,1463,6,1,0,0,3840
2025-09-24,1120,1328,1400,4,2,1,0,3855
2025-09-23,1137,1311,1431,5,2,0,0,3886
2025-09-22,1164,1312,1525,2,2,0,0,4005
2025-09-21,1139,1320,1480,9,0,0,0,3948
2025-09-20,1142,1327,1409,9,2,0,0,3889
2025-09-19,1175,1319,1481,7,1,0,1,3984
2025-09-18,1168,1279,1420,9,2,0,0,3878
2025-09-17,1132,1369,1514,9,2,1,0,4027
2025-09-16,1179,1311,1384,6,3,0,0,3883
2025-09-15,1159,1309,1433,6,2,0,0,3909
2025-09-14,1121,1335,1464,9,0,0,0,3929
2025-09-13,1153,1381,1390,7,1,1,0,3933
2025-09-12,1165,1376,1420,11,3,1,0,3976
2025-09-11,1230,1328,1457,7,1,0,0,4023
2025-09-10,1138,1386,1485,15,2,0,0,4026
2025-09-09,1193,1391,1427,8,3,1,0,4023
2025-09-08,1186,1358,1465,10,2,1,0,4022
2025-09-07,1216,1393,1409,13,0,2,0,4033
2025-09-06,1169,1419,1417,19,1,0,0,4025
2025-09-05,1167,1305,1321,15,4,1,0,3813
2025-09-04,1252,1377,1454,12,0,0,0,4095
2025-09-03,1245,1371,1406,9,3,1,0,4035
2025-09-02,1193,1381,1398,17,1,1,0,3991
2025-09-01,1253,1377,1409,13,0,1,0,4053
2025-08-31,1225,1353,1409,17,2,0,0,4006
2025-08-30,1236,1428,1425,7,2,0,0,4098
2025-08-29,1282,1380,1455,14,2,0,0,4133
2025-08-28,1230,1479,1431,14,2,0,0,4156
2025-08-27,1334,1393,1369,16,2,0,0,4114
2025-08-26,1293,1407,1397,12,3,0,0,4112
2025-08-25,1308,1403,1350,17,1,0,0,4079
2025-08-24,1329,1375,1437,14,5,0,0,4160
2025-08-23,1334,1395,1492,17,4,0,0,4242
2025-08-22,1307,1418,1449,13,1,0,0,4188
2025-08-21,1328,1445,1344,13,1,1,0,4132
2025-08-20,1378,1389,1329,17,3,0,0,4116
2025-08-19,1265,1374,1306,16,1,1,0,3963
2025-08-18,1306,1475,1394,15,2,0,0,4192
2025-08-17,1358,1490,1294,11,1,0,0,4154
2025-08-16,1296,1446,1469,12,2,1,0,4226
2025-08-15,1315,1431,1397,22,1,1,0,4167
2025-08-14,1293,1449,1380,10,5,0,1,4138
2025-08-13,1314,1429,1365,19,2,0,0,4129
2025-08-12,1327,1372,1369,14,4,0,0,4086
2025-08-11,1312,1431,1382,9,6,1,0,4141
2025-08-10,1396,1437,1390,20,4,0,0,4247
2025-08-09,1338,1492,1367,18,5,0,0,4220
2025-08-08,1380,1422,1373,16,2,0,0,4193
2025-08-07,1343,1430,1296,20,2,0,0,4091
2025-08-06,1383,1447,1370,24,4,0,0,4228
2025-08-05,1394,1409,1413,24,1,1,0,4242
2025-08-04,1388,1423,1277,26,3,0,0,4117
2025-08-03,1308,1431,1344,22,7,0,0,4112
2025-08-02,1335,1522,1352,21,5,1,0,4236
2025-08-01,1371,1511,1312,13,6,0,0,4213
2025-07-31,1379,1397,1379,23,4,0,0,4182
2025-07-30,1443,1416,1387,22,2,0,0,4270
2025-07-29,1413,1439,1373,16,3,0,0,4244
2025-07-28,1419,1467,1306,23,5,0,0,4220
2025-07-27,1431,1500,1254,26,1,0,0,4212
2025-07-26,1330,1514,1350,19,4,0,0,4217
2025-07-25,1404,1440,1381,16,3,0,0,4244
2025-07-24,1379,1458,1321,25,5,0,0,4188
2025-07-23,1390,1442,1304,22,3,1,0,4162
2025-07-22,1418,1414,1351,24,4,0,0,4211
2025-07-21,1302,1500,1360,25,7,0,0,4194
2025-07-20,1442,1408,1322,31,3,1,0,4207
2025-07-19,1396,1453,1410,25,1,0,0,4285
2025-07-18,1379,1431,1398,36,3,1,0,4248
2025-07-17,1362,1420,1375,26,0,2,0,4185
2025-07-16,1352,1456,1338,29,0,0,0,4175
2025-07-15,1367,1433,1428,36,4,1,0,4269
2025-07-14,1325,1473,1430,33,4,1,0,4266
2025-07-13,1339,1456,1393,35,1,0,0,4224
2025-07-12,1414,1466,1359,36,4,1,0,4280
2025-07-11,1444,1471,1305,59,6,0,0,4285
2025-07-10,1473,1492,1287,48,1,0,0,4301
2025-07-09,1477,1586,1174,66,1,0,0,4304
2025-07-08,1444,1662,1103,56,3,0,0,4268
2025-07-07,1466,1610,1113,52,1,0,0,4242
2025-07-06,1471,1607,1130,68,1,0,0,4277
2025-07-05,1450,1591,1134,78,3,1,0,4257
2025-07-04,647,728,539,39,3,0,0,1956
2025-07-03,287,300,245,24,0,0,0,856
2025-07-02,1432,1680,1118,102,2,0,0,4334
2025-07-01,1421,1548,1149,125,2,0,0,4245
2025-06-30,1372,1648,1081,119,4,0,0,4224
2025-06-29,1495,1598,1101,134,3,0,0,4331
2025-06-28,1516,1557,1094,194,4,0,0,4365
2025-06-27,1348,1580,1154,190,1,1,0,4274
2025-06-26,1125,1286,1030,193,1,0,0,3635
2025-06-25,280,295,197,64,0,0,0,836
2025-06-24,1260,1380,1035,387,4,0,0,4066
2025-06-23,1283,1383,1047,544,2,0,0,4259
2025-06-22,1250,1313,971,671,5,1,0,4211
2025-06-21,1293,1582,886,464,4,0,0,4229
2025-06-20,1375,1877,996,0,13,0,0,4261
2025-06-19,1367,1875,1028,0,4,0,0,4274
2025-06-18,1414,1903,998,0,4,0,0,4319
2025-06-17,1768,2148,1157,2,5,0,0,5080
2025-06-16,1951,1908,1356,0,3,2,0,5220
2025-06-15,1906,1666,1334,1,5,0,0,4912
2025-06-14,2000,1636,1370,1,3,0,0,5010
2025-06-13,1994,1625,1399,2,9,2,0,5031
2025-06-12,2002,1692,1407,0,13,0,0,5114
2025-06-11,2067,1688,1353,0,2,0,0,5110
2025-06-10,1978,1678,1271,1,9,1,0,4938
2025-06-09,2034,1597,1333,0,5,0,0,4969
2025-06-08,2035,1647,1340,0,10,5,0,5037
2025-06-07,2064,1663,1350,0,8,1,0,5086
2025-06-06,1972,1688,1401,0,11,3,0,5075
2025-06-05,2026,1655,1307,0,4,0,0,4992
2025-06-04,2042,1714,1255,1,13,0,0,5025
2025-06-03,1985,1619,1346,1,4,0,0,4955
2025-06-02,2075,1707,1385,0,5,0,0,5172
2025-06-01,2089,1709,1321,0,5,0,0,5124
2025-05-31,2038,1753,1289,0,7,0,0,5087
2025-05-30,2051,1698,1306,0,6,1,0,5062
2025-05-29,2109,1696,1314,0,3,0,0,5122
2025-05-28,2023,1712,1293,0,5,1,0,5034
2025-05-27,2052,1771,1213,0,3,0,0,5039
2025-05-26,2107,1758,1161,0,10,0,0,5036
2025-05-25,2097,1683,1275,0,4,0,0,5059
2025-05-24,1970,1714,1299,0,5,0,0,4988
2025-05-23,2007,1723,1295,0,2,0,0,5027
2025-05-22,2105,1817,1235,0,8,0,0,5165
2025-05-21,2102,1799,1161,0,2,0,0,5064
2025-05-20,2010,1730,1212,0,5,0,0,4957
2025-05-19,2032,1796,1245,0,3,0,0,5076
2025-05-18,2124,1729,1201,0,6,0,0,5060
2025-05-17,2070,1772,1233,0,5,0,0,5080
2025-05-16,2108,1761,1209,0,9,0,0,5087
2025-05-15,2153,1788,1341,1,7,0,0,5290
2025-05-14,2176,1734,1397,0,4,0,0,5311
2025-05-13,2154,1787,1181,0,2,0,0,5124
2025-05-12,2079,1815,1076,0,3,0,0,4973
2025-05-11,2077,1942,1103,0,5,0,0,5127
2025-05-10,2191,1818,1127,0,4,0,0,5140
2025-05-09,2163,1757,1252,0,3,0,0,5175
2025-05-08,2093,1818,1189,0,17,1,0,5118
2025-05-07,2184,1849,1108,0,4,0,0,5145
2025-05-06,2143,1878,1127,0,1,1,0,5150
2025-05-05,2129,1835,1124,0,9,0,0,5097
2025-05-04,2162,1872,1155,0,4,0,0,5193
2025-05-03,2138,1864,1131,0,3,0,0,5136
2025-05-02,2074,1892,1125,0,2,0,0,5093
2025-05-01,2215,1836,1129,0,9,0,0,5189
2025-04-30,2145,1888,1117,0,7,1,0,5158
2025-04-29,2127,1921,1054,0,3,0,0,5105
2025-04-28,2209,1897,1012,0,4,1,0,5123
2025-04-27,2173,1892,1058,0,7,1,0,5131
2025-04-26,2188,1851,1043,0,4,0,0,5086
2025-04-25,2075,1682,943,0,8,0,0,4708
2025-04-24,1820,1523,896,0,2,0,0,4241
2025-04-23,1934,1561,1025,0,3,0,0,4523
2025-04-22,1971,1670,1014,0,1,0,0,4656
2025-04-21,2393,1851,1324,0,11,0,0,5579
2025-04-20,2290,1902,1426,0,3,0,0,5621
2025-04-19,2285,1860,1477,0,6,0,0,5628
2025-04-18,2268,1868,1494,0,2,0,0,5632
2025-04-17,2224,1863,1536,0,2,0,0,5625
2025-04-16,2247,1889,1397,0,6,0,0,5539
2025-04-15,2191,1939,974,0,12,1,0,5117
2025-04-14,2412,1881,1220,0,9,0,0,5522
2025-04-13,2496,1889,1182,0,11,0,0,5578
2025-04-12,2464,1860,1247,0,12,0,0,5583
2025-04-11,2471,1836,1266,0,12,0,0,5585
2025-04-10,2369,1882,1250,0,14,0,0,5515
2025-04-09,2402,1869,1243,0,11,1,0,5526
2025-04-08,2316,1885,1241,0,11,0,0,5453
2025-04-07,2325,1862,1281,0,4,0,0,5472
2025-04-06,2246,1872,1323,0,12,1,0,5454
2025-04-05,2240,1881,1302,0,6,1,1,5431
2025-04-04,2207,1868,1318,0,6,0,0,5399
2025-04-03,2036,1755,1331,0,4,0,0,5126
2025-04-02,2114,1862,1305,0,8,0,0,5289
2025-04-01,2109,1846,1370,0,4,0,0,5329
2025-03-31,2035,1804,1332,0,3,0,0,5174
2025-03-30,2019,1790,1314,0,1,0,0,5124
2025-03-29,2173,1852,1278,0,3,0,0,5306
2025-03-28,2008,1880,1351,0,1,0,0,5240
2025-03-27,1887,1915,1498,0,0,0,0,5300
2025-03-26,1940,1817,544,0,2,0,0,4303
2025-03-25,1958,1812,623,1,2,0,0,4396
2025-03-24,2080,1926,585,0,3,0,0,4594
2025-03-23,2104,1878,578,0,3,0,0,4563
2025-03-22,1973,1875,556,0,5,0,0,4409
2025-03-21,2073,1913,569,0,3,0,0,4558
2025-03-20,2083,1887,544,0,3,0,0,4517
2025-03-19,2093,1849,535,0,5,0,0,4482
2025-03-18,2090,1890,516,0,3,0,1,4500
2025-03-17,2098,1779,518,0,4,0,0,4399
2025-03-16,2164,1884,461,0,3,0,0,4512
2025-03-15,2128,1861,446,0,0,1,0,4436
2025-03-14,2088,1928,432,0,2,0,0,4450
2025-03-13,2061,1861,473,0,1,0,0,4396
2025-03-12,1974,1923,453,0,7,0,0,4357
2025-03-11,2081,1886,422,0,2,0,0,4391
2025-03-10,1886,1928,396,0,4,0,0,4214
2025-03-09,2006,1887,422,0,2,1,0,4318
2025-03-08,1998,1888,430,0,4,0,0,4320
2025-03-07,2072,1898,379,0,2,0,0,4351
2025-03-06,2015,1893,395,0,1,1,0,4305
2025-03-05,1942,1935,387,0,1,0,0,4265
2025-03-04,1947,1939,350,0,3,2,1,4242
2025-03-03,2331,1891,489,0,15,2,0,4728
2025-03-02,2326,1908,591,0,13,6,0,4844
2025-03-01,2430,1882,558,0,15,1,0,4886
2025-02-28,2520,1866,322,1,18,5,0,4732
2025-02-27,2487,1879,297,0,12,3,1,4679
2025-02-26,2506,1845,297,2,25,4,0,4679
2025-02-25,2491,1878,310,0,22,1,0,4702
2025-02-24,2459,1842,309,0,19,2,0,4631
2025-02-23,2437,1829,303,0,15,3,0,4587
2025-02-22,2394,1829,291,1,10,0,0,4525
2025-02-21,2421,1821,271,0,19,2,1,4535
2025-02-20,2469,1847,247,0,18,0,0,4581
2025-02-19,2417,1767,238,0,25,3,0,4450
2025-02-18,2430,1812,231,0,15,3,1,4492
2025-02-17,2447,1827,226,0,22,3,1,4526
2025-02-16,2400,1757,202,0,23,1,0,4383
2025-02-15,2368,1901,175,1,18,2,0,4465
2025-02-14,2399,1830,143,0,15,5,0,4392
2025-02-13,2402,1805,169,0,18,2,0,4396
2025-02-12,2364,1757,6054,0,25,4,0,10204
2025-02-11,2276,1741,9606,0,24,2,0,13649
2025-02-10,2123,1566,9845,0,17,6,0,13557
2025-02-09,1923,1602,6539,0,15,4,1,10084
2025-02-08,1896,1657,462,0,14,2,1,4032
2025-02-07,1805,1585,554,0,12,1,0,3957
2025-02-06,1585,1638,467,0,9,2,0,3701
2025-02-05,1769,1622,512,0,7,2,0,3912
2025-02-04,1636,1538,477,1,9,2,0,3663
2025-02-03,1584,1683,542,0,8,2,0,3819
2025-02-02,1587,1641,504,0,7,0,0,3739
2025-02-01,1485,1680,538,0,2,1,0,3706
2025-01-31,1410,1694,484,0,13,1,0,3602
2025-01-30,1410,1636,557,0,7,1,1,3612
2025-01-29,1297,1665,571,0,6,1,0,3540
2025-01-28,1211,1649,514,0,14,1,0,3389
2025-01-27,1180,1641,521,0,7,0,1,3350
2025-01-26,1092,1587,515,0,13,2,0,3209
2025-01-25,1064,1529,597,0,6,2,0,3198
2025-01-24,969,1547,562,0,7,2,0,3087
2025-01-23,845,1467,624,0,7,1,0,2944
2025-01-22,562,763,427,66,7,1,0,1826
2025-01-21,368,455,288,2677,5,0,0,3793
2025-01-20,155,316,28,770,4,0,0,1273
2025-01-19,70,191,17,0,4,1,0,283
2025-01-18,25,112,19,0,3,0,0,159
2025-01-17,2,30,9,0,0,0,0,41
