date,douban,douban_celebrity,imdb,bangumi,steam,indienova,epic,total_count
2025-10-05,1015,1189,1386,3,2,0,0,3595
2025-10-04,1038,1251,1417,10,2,0,0,3718
2025-10-03,1085,1313,1403,6,1,0,0,3808
2025-10-02,1069,1294,1432,11,1,0,0,3807
2025-10-01,1010,1287,1360,6,3,0,0,3666
2025-09-30,1094,1323,1478,8,1,1,0,3905
2025-09-29,1023,1253,1462,9,1,0,0,3748
2025-09-28,1034,1320,1434,8,1,0,0,3797
2025-09-27,1166,1279,1486,6,3,0,0,3940
2025-09-26,1170,1242,1512,5,3,0,0,3932
2025-09-25,1046,1324,1463,6,1,0,0,3840
2025-09-24,1120,1328,1400,4,2,1,0,3855
2025-09-23,1137,1311,1431,5,2,0,0,3886
2025-09-22,1164,1312,1525,2,2,0,0,4005
2025-09-21,1139,1320,1480,9,0,0,0,3948
2025-09-20,1142,1327,1409,9,2,0,0,3889
2025-09-19,1175,1319,1481,7,1,0,1,3984
2025-09-18,1168,1279,1420,9,2,0,0,3878
2025-09-17,1132,1369,1514,9,2,1,0,4027
2025-09-16,1179,1311,1384,6,3,0,0,3883
2025-09-15,1159,1309,1433,6,2,0,0,3909
2025-09-14,1121,1335,1464,9,0,0,0,3929
2025-09-13,1153,1381,1390,7,1,1,0,3933
2025-09-12,1165,1376,1420,11,3,1,0,3976
2025-09-11,1230,1328,1457,7,1,0,0,4023
2025-09-10,1138,1386,1485,15,2,0,0,4026
2025-09-09,1193,1391,1427,8,3,1,0,4023
2025-09-08,1186,1358,1465,10,2,1,0,4022
2025-09-07,1216,1393,1409,13,0,2,0,4033
2025-09-06,1169,1419,1417,19,1,0,0,4025
2025-09-05,1167,1305,1321,15,4,1,0,3813
2025-09-04,1252,1377,1454,12,0,0,0,4095
2025-09-03,1245,1371,1406,9,3,1,0,4035
2025-09-02,1193,1381,1398,17,1,1,0,3991
2025-09-01,1253,1377,1409,13,0,1,0,4053
2025-08-31,1225,1353,1409,17,2,0,0,4006
2025-08-30,1236,1428,1425,7,2,0,0,4098
2025-08-29,1282,1380,1455,14,2,0,0,4133
2025-08-28,1230,1479,1431,14,2,0,0,4156
2025-08-27,1334,1393,1369,16,2,0,0,4114
2025-08-26,1293,1407,1397,12,3,0,0,4112
2025-08-25,1308,1403,1350,17,1,0,0,4079
2025-08-24,1329,1375,1437,14,5,0,0,4160
2025-08-23,1334,1395,1492,17,4,0,0,4242
2025-08-22,1307,1418,1449,13,1,0,0,4188
2025-08-21,1328,1445,1344,13,1,1,0,4132
2025-08-20,1378,1389,1329,17,3,0,0,4116
2025-08-19,1265,1374,1306,16,1,1,0,3963
2025-08-18,1306,1475,1394,15,2,0,0,4192
2025-08-17,1358,1490,1294,11,1,0,0,4154
2025-08-16,1296,1446,1469,12,2,1,0,4226
2025-08-15,1315,1431,1397,22,1,1,0,4167
2025-08-14,1293,1449,1380,10,5,0,1,4138
2025-08-13,1314,1429,1365,19,2,0,0,4129
2025-08-12,1327,1372,1369,14,4,0,0,4086
2025-08-11,1312,1431,1382,9,6,1,0,4141
2025-08-10,1396,1437,1390,20,4,0,0,4247
2025-08-09,1338,1492,1367,18,5,0,0,4220
2025-08-08,1380,1422,1373,16,2,0,0,4193
2025-08-07,1343,1430,1296,20,2,0,0,4091
2025-08-06,1383,1447,1370,24,4,0,0,4228
2025-08-05,1394,1409,1413,24,1,1,0,4242
2025-08-04,1388,1423,1277,26,3,0,0,4117
2025-08-03,1308,1431,1344,22,7,0,0,4112
2025-08-02,1335,1522,1352,21,5,1,0,4236
2025-08-01,1371,1511,1312,13,6,0,0,4213
2025-07-31,1379,1397,1379,23,4,0,0,4182
2025-07-30,1443,1416,1387,22,2,0,0,4270
2025-07-29,1413,1439,1373,16,3,0,0,4244
2025-07-28,1419,1467,1306,23,5,0,0,4220
2025-07-27,1431,1500,1254,26,1,0,0,4212
2025-07-26,1330,1514,1350,19,4,0,0,4217
2025-07-25,1404,1440,1381,16,3,0,0,4244
2025-07-24,1379,1458,1321,25,5,0,0,4188
2025-07-23,1390,1442,1304,22,3,1,0,4162
2025-07-22,1418,1414,1351,24,4,0,0,4211
2025-07-21,1302,1500,1360,25,7,0,0,4194
2025-07-20,1442,1408,1322,31,3,1,0,4207
2025-07-19,1396,1453,1410,25,1,0,0,4285
2025-07-18,1379,1431,1398,36,3,1,0,4248
2025-07-17,1362,1420,1375,26,0,2,0,4185
2025-07-16,1352,1456,1338,29,0,0,0,4175
2025-07-15,1367,1433,1428,36,4,1,0,4269
2025-07-14,1325,1473,1430,33,4,1,0,4266
2025-07-13,1339,1456,1393,35,1,0,0,4224
2025-07-12,1414,1466,1359,36,4,1,0,4280
2025-07-11,1444,1471,1305,59,6,0,0,4285
2025-07-10,1473,1492,1287,48,1,0,0,4301
2025-07-09,1477,1586,1174,66,1,0,0,4304
2025-07-08,1444,1662,1103,56,3,0,0,4268
2025-07-07,1466,1610,1113,52,1,0,0,4242
2025-07-06,1471,1607,1130,68,1,0,0,4277
2025-07-05,1450,1591,1134,78,3,1,0,4257
2025-07-04,647,728,539,39,3,0,0,1956
2025-07-03,287,300,245,24,0,0,0,856
2025-07-02,1432,1680,1118,102,2,0,0,4334
2025-07-01,1421,1548,1149,125,2,0,0,4245
2025-06-30,1372,1648,1081,119,4,0,0,4224
2025-06-29,1495,1598,1101,134,3,0,0,4331
2025-06-28,1516,1557,1094,194,4,0,0,4365
2025-06-27,1348,1580,1154,190,1,1,0,4274
2025-06-26,1125,1286,1030,193,1,0,0,3635
2025-06-25,280,295,197,64,0,0,0,836
2025-06-24,1260,1380,1035,387,4,0,0,4066
2025-06-23,1283,1383,1047,544,2,0,0,4259
2025-06-22,1250,1313,971,671,5,1,0,4211
2025-06-21,1293,1582,886,464,4,0,0,4229
2025-06-20,1375,1877,996,0,13,0,0,4261
2025-06-19,1367,1875,1028,0,4,0,0,4274
2025-06-18,1414,1903,998,0,4,0,0,4319
2025-06-17,1768,2148,1157,2,5,0,0,5080
2025-06-16,1951,1908,1356,0,3,2,0,5220
2025-06-15,1906,1666,1334,1,5,0,0,4912
2025-06-14,2000,1636,1370,1,3,0,0,5010
2025-06-13,1994,1625,1399,2,9,2,0,5031
2025-06-12,2002,1692,1407,0,13,0,0,5114
2025-06-11,2067,1688,1353,0,2,0,0,5110
2025-06-10,1978,1678,1271,1,9,1,0,4938
2025-06-09,2034,1597,1333,0,5,0,0,4969
2025-06-08,2035,1647,1340,0,10,5,0,5037
2025-06-07,2064,1663,1350,0,8,1,0,5086
2025-06-06,1972,1688,1401,0,11,3,0,5075
2025-06-05,2026,1655,1307,0,4,0,0,4992
2025-06-04,2042,1714,1255,1,13,0,0,5025
2025-06-03,1985,1619,1346,1,4,0,0,4955
2025-06-02,2075,1707,1385,0,5,0,0,5172
2025-06-01,2089,1709,1321,0,5,0,0,5124
2025-05-31,2038,1753,1289,0,7,0,0,5087
2025-05-30,2051,1698,1306,0,6,1,0,5062
2025-05-29,2109,1696,1314,0,3,0,0,5122
2025-05-28,2023,1712,1293,0,5,1,0,5034
2025-05-27,2052,1771,1213,0,3,0,0,5039
2025-05-26,2107,1758,1161,0,10,0,0,5036
2025-05-25,2097,1683,1275,0,4,0,0,5059
2025-05-24,1970,1714,1299,0,5,0,0,4988
2025-05-23,2007,1723,1295,0,2,0,0,5027
2025-05-22,2105,1817,1235,0,8,0,0,5165
2025-05-21,2102,1799,1161,0,2,0,0,5064
2025-05-20,2010,1730,1212,0,5,0,0,4957
2025-05-19,2032,1796,1245,0,3,0,0,5076
2025-05-18,2124,1729,1201,0,6,0,0,5060
2025-05-17,2070,1772,1233,0,5,0,0,5080
2025-05-16,2108,1761,1209,0,9,0,0,5087
2025-05-15,2153,1788,1341,1,7,0,0,5290
2025-05-14,2176,1734,1397,0,4,0,0,5311
2025-05-13,2154,1787,1181,0,2,0,0,5124
2025-05-12,2079,1815,1076,0,3,0,0,4973
2025-05-11,2077,1942,1103,0,5,0,0,5127
2025-05-10,2191,1818,1127,0,4,0,0,5140
2025-05-09,2163,1757,1252,0,3,0,0,5175
2025-05-08,2093,1818,1189,0,17,1,0,5118
2025-05-07,2184,1849,1108,0,4,0,0,5145
2025-05-06,2143,1878,1127,0,1,1,0,5150
2025-05-05,2129,1835,1124,0,9,0,0,5097
2025-05-04,2155,1870,1152,0,4,0,0,5181
2025-05-03,2129,1854,1127,0,3,0,0,5113
2025-05-02,2068,1884,1119,0,2,0,0,5073
2025-05-01,2197,1815,1123,0,9,0,0,5144
2025-04-30,2122,1878,1110,0,7,1,0,5118
2025-04-29,2111,1909,1050,0,3,0,0,5073
2025-04-28,2189,1886,1009,0,4,1,0,5089
2025-04-27,2155,1874,1050,0,7,1,0,5087
2025-04-26,2166,1837,1036,0,4,0,0,5043
2025-04-25,2062,1671,938,0,8,0,0,4679
2025-04-24,1798,1510,892,0,2,0,0,4202
2025-04-23,1921,1556,1019,0,3,0,0,4499
2025-04-22,1960,1659,1003,0,1,0,0,4623
2025-04-21,2375,1831,1315,0,11,0,0,5532
2025-04-20,2271,1887,1416,0,3,0,0,5577
2025-04-19,2258,1849,1452,0,6,0,0,5565
2025-04-18,2256,1853,1477,0,2,0,0,5588
2025-04-17,2210,1841,1525,0,2,0,0,5578
2025-04-16,2229,1879,1388,0,6,0,0,5502
2025-04-15,2177,1921,969,0,12,1,0,5080
2025-04-14,2398,1868,1212,0,9,0,0,5487
2025-04-13,2465,1869,1170,0,11,0,0,5515
2025-04-12,2455,1847,1235,0,11,0,0,5548
2025-04-11,2451,1826,1258,0,12,0,0,5547
2025-04-10,2355,1865,1238,0,14,0,0,5472
2025-04-09,2383,1856,1232,0,11,1,0,5483
2025-04-08,2289,1868,1232,0,11,0,0,5400
2025-04-07,2308,1851,1271,0,4,0,0,5434
2025-04-06,2218,1858,1317,0,12,1,0,5406
2025-04-05,2226,1861,1294,0,6,1,1,5389
2025-04-04,2185,1851,1308,0,5,0,0,5349
2025-04-03,2016,1732,1314,0,4,0,0,5066
2025-04-02,2102,1847,1297,0,8,0,0,5254
2025-04-01,2092,1830,1364,0,4,0,0,5290
2025-03-31,2015,1789,1319,0,3,0,0,5126
2025-03-30,2008,1775,1296,0,1,0,0,5080
2025-03-29,2156,1835,1271,0,3,0,0,5265
2025-03-28,1986,1870,1345,0,1,0,0,5202
2025-03-27,1864,1899,1482,0,0,0,0,5245
2025-03-26,1918,1802,542,0,2,0,0,4264
2025-03-25,1939,1799,616,1,2,0,0,4357
2025-03-24,2058,1907,579,0,3,0,0,4547
2025-03-23,2078,1865,572,0,3,0,0,4518
2025-03-22,1950,1860,553,0,5,0,0,4368
2025-03-21,2062,1895,567,0,3,0,0,4527
2025-03-20,2067,1869,542,0,3,0,0,4481
2025-03-19,2069,1840,532,0,5,0,0,4446
2025-03-18,2075,1874,513,0,3,0,1,4466
2025-03-17,2084,1756,516,0,4,0,0,4360
2025-03-16,2135,1872,457,0,3,0,0,4467
2025-03-15,2118,1848,443,0,0,1,0,4410
2025-03-14,2073,1904,430,0,2,0,0,4409
2025-03-13,2048,1842,470,0,1,0,0,4361
2025-03-12,1954,1907,448,0,7,0,0,4316
2025-03-11,2072,1877,421,0,2,0,0,4372
2025-03-10,1871,1914,393,0,4,0,0,4182
2025-03-09,1992,1868,418,0,2,1,0,4281
2025-03-08,1979,1872,427,0,4,0,0,4282
2025-03-07,2047,1881,375,0,2,0,0,4305
2025-03-06,1998,1881,391,0,1,1,0,4272
2025-03-05,1921,1918,382,0,1,0,0,4222
2025-03-04,1928,1925,349,0,3,2,1,4208
2025-03-03,2313,1876,486,0,15,2,0,4692
2025-03-02,2308,1895,585,0,13,6,0,4807
2025-03-01,2417,1872,550,0,15,1,0,4855
2025-02-28,2496,1850,318,1,18,5,0,4688
2025-02-27,2479,1863,295,0,12,3,1,4653
2025-02-26,2478,1836,296,2,25,4,0,4641
2025-02-25,2470,1862,306,0,22,1,0,4661
2025-02-24,2446,1834,306,0,19,2,0,4607
2025-02-23,2410,1811,303,0,15,3,0,4542
2025-02-22,2380,1806,290,1,10,0,0,4487
2025-02-21,2407,1808,270,0,19,2,1,4507
2025-02-20,2445,1826,245,0,18,0,0,4534
2025-02-19,2399,1753,236,0,23,3,0,4414
2025-02-18,2412,1794,228,0,15,3,1,4453
2025-02-17,2431,1813,224,0,22,3,1,4494
2025-02-16,2385,1742,201,0,23,1,0,4352
2025-02-15,2344,1890,173,1,18,2,0,4428
2025-02-14,2374,1810,143,0,15,5,0,4347
2025-02-13,2377,1790,167,0,18,2,0,4354
2025-02-12,2347,1744,5996,0,25,4,0,10116
2025-02-11,2260,1728,9540,0,24,2,0,13554
2025-02-10,2103,1550,9775,0,17,6,0,13451
2025-02-09,1911,1590,6484,0,15,4,1,10005
2025-02-08,1874,1649,458,0,13,2,1,3997
2025-02-07,1787,1570,553,0,12,1,0,3923
2025-02-06,1575,1628,466,0,9,2,0,3680
2025-02-05,1752,1609,508,0,7,2,0,3878
2025-02-04,1617,1520,471,1,9,2,0,3620
2025-02-03,1571,1669,534,0,8,2,0,3784
2025-02-02,1575,1625,498,0,7,0,0,3705
2025-02-01,1474,1665,532,0,2,1,0,3674
2025-01-31,1398,1682,481,0,13,1,0,3575
2025-01-30,1401,1629,552,0,7,1,1,3591
2025-01-29,1285,1650,565,0,6,1,0,3507
2025-01-28,1203,1636,505,0,14,1,0,3359
2025-01-27,1169,1634,517,0,7,0,1,3328
2025-01-26,1083,1573,512,0,13,2,0,3183
2025-01-25,1051,1517,594,0,5,2,0,3169
2025-01-24,960,1540,558,0,7,2,0,3067
2025-01-23,840,1454,619,0,7,1,0,2921
2025-01-22,558,757,423,66,7,1,0,1812
2025-01-21,366,449,287,2661,5,0,0,3768
2025-01-20,154,314,28,758,4,0,0,1258
2025-01-19,70,189,16,0,4,1,0,280
2025-01-18,25,112,19,0,3,0,0,159
2025-01-17,2,29,9,0,0,0,0,40
