date,douban,douban_celebrity,imdb,bangumi,steam,indienova,epic,total_count
2025-03-21,2242,2011,623,0,3,0,0,4879
2025-03-20,2337,2089,619,0,3,0,0,5048
2025-03-19,2357,2071,598,0,6,0,0,5032
2025-03-18,2343,2147,569,0,4,0,1,5064
2025-03-17,2360,2052,578,0,4,0,0,4994
2025-03-16,2464,2110,535,0,4,0,0,5113
2025-03-15,2393,2107,512,0,0,1,0,5013
2025-03-14,2376,2193,501,0,2,0,0,5072
2025-03-13,2354,2096,535,0,1,0,0,4986
2025-03-12,2272,2199,516,0,7,0,0,4994
2025-03-11,2391,2178,484,0,2,0,0,5055
2025-03-10,2205,2251,463,0,6,0,0,4925
2025-03-09,2332,2212,490,0,2,1,0,5037
2025-03-08,2339,2215,505,0,5,0,0,5064
2025-03-07,2407,2217,429,0,2,0,0,5055
2025-03-06,2354,2224,455,0,1,1,0,5035
2025-03-05,2298,2290,476,0,1,0,0,5065
2025-03-04,2335,2285,392,0,3,2,1,5018
2025-03-03,2827,2234,574,0,16,3,0,5654
2025-03-02,2790,2314,723,0,17,7,0,5851
2025-03-01,2909,2265,668,0,19,1,0,5862
2025-02-28,3052,2280,398,1,20,6,0,5757
2025-02-27,3082,2307,367,0,21,4,1,5782
2025-02-26,3129,2294,372,2,27,4,0,5828
2025-02-25,3077,2299,388,0,27,1,0,5792
2025-02-24,3104,2267,397,0,23,3,0,5794
2025-02-23,3097,2304,378,0,21,4,0,5804
2025-02-22,3087,2351,369,1,15,0,0,5823
2025-02-21,3157,2306,334,0,23,4,2,5826
2025-02-20,3137,2395,310,0,24,1,0,5867
2025-02-19,3126,2313,300,0,33,4,0,5776
2025-02-18,3151,2378,291,1,22,3,1,5847
2025-02-17,3179,2382,281,0,26,4,1,5873
2025-02-16,3174,2352,270,0,34,2,0,5832
2025-02-15,3078,2475,230,1,21,2,0,5807
2025-02-14,3207,2403,204,0,20,5,0,5839
2025-02-13,3182,2364,215,0,20,3,0,5784
2025-02-12,3236,2337,8040,0,37,4,0,13654
2025-02-11,3096,2343,13122,0,34,2,0,18597
2025-02-10,2944,2222,13364,0,23,8,0,18561
2025-02-09,2694,2218,9125,0,22,5,1,14065
2025-02-08,2608,2325,666,0,19,3,1,5622
2025-02-07,2531,2279,768,0,18,1,0,5597
2025-02-06,2248,2337,674,0,15,3,0,5277
2025-02-05,2550,2327,744,0,11,3,0,5635
2025-02-04,2435,2291,700,1,13,2,0,5442
2025-02-03,2347,2473,781,0,13,2,0,5616
2025-02-02,2371,2499,760,0,15,1,0,5646
2025-02-01,2238,2555,785,0,6,2,0,5586
2025-01-31,2188,2566,779,0,16,3,0,5552
2025-01-30,2187,2535,867,0,12,2,2,5605
2025-01-29,2060,2621,871,0,11,3,0,5566
2025-01-28,2021,2649,872,0,20,3,0,5565
2025-01-27,1991,2696,908,0,12,0,1,5608
2025-01-26,1894,2754,896,0,18,2,0,5564
2025-01-25,1840,2666,1012,0,8,3,0,5529
2025-01-24,1715,2821,998,0,13,2,0,5549
2025-01-23,1618,2768,1184,0,12,1,0,5583
2025-01-22,1167,1511,885,142,13,1,0,3719
2025-01-21,857,934,660,6067,16,0,0,8534
2025-01-20,466,871,79,2239,8,0,0,3663
2025-01-19,314,1073,93,0,20,2,0,1502
2025-01-18,318,1075,160,0,10,0,0,1563
2025-01-17,325,1075,149,0,5,0,0,1554
2025-01-16,326,703,61,2,5,0,0,1097
2025-01-15,320,293,79,0,3,2,0,697
2025-01-14,333,0,73,1,5,0,0,412
2025-01-13,327,0,61,0,3,0,0,391
2025-01-12,337,0,96,0,9,2,0,444
2025-01-11,332,0,110,0,13,0,0,455
2025-01-10,326,0,107,0,2,0,0,435
2025-01-09,328,0,95,1,9,1,0,434
2025-01-08,344,0,75,0,5,0,0,424
2025-01-07,304,0,143,0,10,5,0,462
2025-01-06,326,0,95,0,8,1,0,430
2025-01-05,312,0,115,0,11,3,0,441
2025-01-04,334,0,88,0,4,0,0,426
2025-01-03,328,0,88,0,13,0,0,429
2025-01-02,323,0,119,1,4,0,0,447
2025-01-01,347,0,176,0,5,0,0,528
2024-12-31,341,0,122,0,5,0,0,468
2024-12-30,328,0,101,0,7,0,0,436
2024-12-29,330,0,98,0,6,1,0,435
2024-12-28,313,0,134,0,3,0,0,450
2024-12-27,319,0,106,0,5,1,0,431
2024-12-26,326,0,102,0,3,0,0,431
2024-12-25,341,0,91,0,10,0,0,442
2024-12-24,323,0,113,0,4,0,0,440
2024-12-23,294,0,154,0,5,0,0,453
2024-12-22,342,0,127,0,2,0,0,471
2024-12-21,339,0,150,0,8,0,0,497
2024-12-20,321,0,127,0,2,0,0,450
2024-12-19,329,0,107,0,5,0,0,441
2024-12-18,284,0,153,0,3,0,0,440
2024-12-17,328,0,123,0,6,0,0,457
2024-12-16,322,0,115,0,5,0,0,442
2024-12-15,328,0,116,0,9,0,0,453
2024-12-14,367,0,274,1,7,0,0,649
2024-12-13,350,0,344,0,4,0,0,698
2024-12-12,337,0,103,0,2,0,0,442
2024-12-11,317,0,39,0,3,0,0,359
2024-12-10,308,0,89,0,5,0,0,402
2024-12-09,335,0,174,0,4,0,0,513
2024-12-08,348,0,207,0,3,0,0,558
2024-12-07,345,0,177,0,17,1,0,540
2024-12-06,356,0,149,0,4,0,0,509
2024-12-05,314,0,158,0,1,1,0,474
2024-12-04,338,0,171,0,9,0,0,518
2024-12-03,288,0,176,0,4,0,0,468
2024-12-02,337,0,125,0,3,0,0,465
2024-12-01,315,0,171,0,2,0,0,488
2024-11-30,356,0,192,0,9,0,0,557
2024-11-29,355,0,156,0,7,1,0,519
2024-11-28,349,0,151,0,3,0,0,503
2024-11-27,348,0,132,0,4,1,0,485
2024-11-26,350,0,157,0,7,1,0,515
2024-11-25,337,0,160,0,4,0,0,501
2024-11-24,343,0,139,0,8,0,0,490
2024-11-23,323,0,159,0,2,0,0,484
2024-11-22,349,0,242,0,3,0,0,594
2024-11-21,348,0,260,0,1,1,0,610
2024-11-20,360,0,255,0,11,0,0,626
2024-11-19,391,0,268,0,1,0,0,660
2024-11-18,456,0,612,0,5,0,0,1073
2024-11-17,498,0,868,0,4,0,0,1370
2024-11-16,519,0,1117,0,3,0,0,1639
2024-11-15,379,0,595,0,7,0,0,981
2024-11-14,321,0,206,0,12,1,0,540
2024-11-13,336,0,196,0,4,0,0,536
2024-11-12,337,0,167,0,3,0,0,507
2024-11-11,322,0,217,0,6,0,0,545
2024-11-10,334,0,213,0,9,0,0,556
2024-11-09,328,0,258,0,12,0,0,598
2024-11-08,347,0,176,0,8,1,0,532
2024-11-07,339,0,178,0,5,0,0,522
2024-11-06,346,0,190,0,12,0,0,548
2024-11-05,319,0,215,1,11,0,0,546
2024-11-04,344,0,250,0,8,0,0,602
2024-11-03,365,0,299,0,5,1,0,670
2024-11-02,343,0,303,0,13,0,0,659
2024-11-01,357,0,302,0,0,0,0,659
2024-10-31,341,0,275,0,9,0,0,625
2024-10-30,322,0,299,0,5,0,0,626
2024-10-29,324,0,255,0,10,0,1,590
2024-10-28,358,0,315,0,2,0,0,675
2024-10-27,1866,0,2059,0,12,1,0,3938
2024-10-26,254,0,6272,0,7,0,0,6533
2024-10-25,183,0,7,0,2,0,0,192
2024-10-24,266,0,22,1,2,0,0,291
2024-10-23,287,0,24,0,3,0,0,314
2024-10-22,301,0,14,0,3,0,0,318
2024-10-21,293,0,26,0,5,0,0,324
